1,2,2,2,2,2,2,2,2,3,
9,0,0,0,0,0,0,0,0,9,
9,0,0,0,0,0,0,0,0,9,
9,0,0,10,0,0,10,0,0,9,
9,0,0,0,0,0,0,0,0,9,
9,0,0,0,0,0,0,0,0,9,
9,0,0,10,0,0,10,0,0,9,
9,0,0,0,0,0,0,0,0,9,
9,0,0,0,0,0,0,0,0,9,
17,2,2,2,2,2,2,2,2,19
